++++++++++++++++++++++++++++++++
+ ++++                         +
+      +++++++++++++++++++++++++
+ +    +                       +
+ ++++ +++++++++++++++++++++++ +
+ +    +                       +
+ +    +++++++++++++++++++++++ +
+ +                           +
+ +          +++++++++++++++++ +
+ +                           +
+ +++++++++ ++++++++++++++++++ +
+ +                           +
+ +++++++++ ++++++++++++++++++ +
+ +                           +
+                              +
+                             +
+ ++++++++++++++++++++++++++++ +
+ +                           +
+ ++++++++++++++++++++++++++++ +
+ +                           +
+ +++++++++++++++              +
+                  +++++++++++++             
+                              +                 
++++++++++++++++++++++++++++++++