++++++++++++++++++++++++++++++++
+ +            +++           ++
+    ++++++  ++++++++++++++++   +
+          ++             ++   +
+     +++++               +    +
+         +               +    +
+   +    +                 +   +
+   +    +                 +   +
+   +    +                 +   +
+    +    +               +    +
+    +     ++++++++++++++     +
+    +                         +
+   +                         +
+   +    +               +    +
+   +    +               +    +
+    +    +             +    +
+    +    +             +    +
+   +      ++++++++++++++      +
+   +                         +
+  +    +                 +    +
+  +    +                 +    +
+  +    +                 +    +
++++++++++++++++++++++++++++++++
